   x x         x       x xx             
        x     x  x    x x       x  x    
   xx  x    x x xxx   x    x    x    x  
x              x    xxx   x         x  x
x    xx x      x xx        xx  xxx  xxx 
 x    x      x x x            x     x   
        xx   x  x       x     x       xx
     x    x                  xx x      x
x x     x     x     xx  x  x   xxx x    
   x    x       xx   xx x x x  x    xxx 
x     xxx   xx           x   x  xxx   x 
      xx x x     x             x   x  xx
    xx     x        xx x    xxx         
xx   xx     x x  x  x xx x   xx xx x  x 
x  x xx   x  x  xx x  x x   xxx x xx    
 x  x   xx     x        x   x   xx  x   
     x x   x x    x          x    xx   x
 x   x        xx x  x xx   x  x x xx  x 
x    x          x x   x   x x   x       
    xx xx    xxx x     x x x      x x x 
 x  x x          x x x x    x   x     x 
     x x  x x  xx       xx   x x x x    
       x x x  x   x    x x  xx       x  
     x        x   x          x       xx 
 x     xxx  x   x   x   xxx x           
 x   xxxx   x    x   x xx  xx xx x     x
  x x             xx      xx     xx     
 x      x          x  x x   x xx        
  x   x      x   x   xx  x   x   xx   xx
 x xx   xx x xx        x  xx  x  x   x  
 x     x xx x     x       x      x      
x   xx  xxx xx  x x    x  x xxxx     x  
      x   x  x x  x        x x xxx  x   
   x  xx x x  x x     xx   x     x      
        xx  x    xx       x xx x     x  
  x          xx      x         x x x    
      xxx     x  x      x         xx   x
xx  x      x    xx      xx       x      
   xx xxx x   x  x   x   x    x x      x
x   x x       xx   x x      x           
