   x  x    x  x       x  xxxx  x      x 
  xx  x    xxx x   x x      x    xx  x  
   x      xx      xx x   xx x x  x  x   
x  x x x xx xx x   x xx x      x   x   x
  x         x   x    x    x  x          
 x  x x x     x  xx x xx    xx   xx     
      xx  x     x     xxx x    xxx x    
xx x                 x   x     x  xxx   
       x    x x         xxx      x  x   
x x  x  xx     x     x xx x  xx   x   xx
 x   x x   x        x    x  x     x x x 
    x          x x xx   x          xxx  
 x      xx     x   x      xx   x   x   x
x         x      x x   x xxxx x x       
 xxx x x   x   x      x    xxx  xx x    
  xx         xxx   x             xxx    
    x          xx    x  xx     x   xx   
  x                x  x  x   x  xx  x  x
 xx     xxxx      x     x         x x   
    xx x      x   x      x  x  xxx x  x 
x   x      x     x       x   xx xx      
    x   xx         xx xx     xx    x    
x  x  x x       x   x    xx  x   x x   x
      x x     x xx       x    x       x 
 x   xxx  x x  x     x  x xx   x  x     
  xx x              x              x  x 
x      x  x            x    x  xxx    xx
 x    x   xx  x x         xx      x  x  
 x xxxx x x     xx   x xxx  xx xxx      
x   x    xx   x x         x x  x     xx 
x x    xx x    xxx    x x   x xxx   x   
   x  xx    x          xxx              
   x x             x x x x x     x      
xx   xxx  xxxx     x   x         x  x   
  x   xx x        x  xx   x   x x       
     x x      x  x  x        x x       x
        x    xx  xx              x  x  x
x x   xx    x x          xx xxxx   xxx  
  x        xx     x x        x x     x  
 xx      x x   xxxxx x         x      x 
